shown = mostrando
augmented = aumentado
elaborate = elaborar
remain = permanecer
however = no entanto
kind = tipo	
had = tive	
own = ter
would = seria
became = tornou-se
thought = pensamento
evolved = evoluiu
evolve = evoluir
became = tornou-se
increasingly = cada vez mais
beings = seres
keep = manter
track = acompanhar
wealth = riqueza/fortuna	
began = começou
begin = começar
most = maioria
those = aqueles
these = esses
could = poderia	
closely = de perto
resembling = parecendo
led = liderado
arguably = discutivelmente
notably = notavelmente	
remained = permaneceu
catch = pegar
effort = esforço
increases = aumenta	
improvements = melhorias
even = até
labor = trabalho
costs = custos
heavily = pesadamente
several = diversas
saw = serra
statements = declarações
nested = aninhado